@ @@@@@@@@@@@@@@@@@@@@@@@@@@@@@@@@@@@@@@@@@@@@@@@@@@@@@@@@@
@          @@@@@@@@@         @@@@@                     @@@@
@@@@@@@@@@ @@@@@@@@@ @@@@@@@ @@@@@ @@@@@@@@@@@@@@@@@@@ @@@@
@@@@@@@@@@           @@@@@@@   @@@ @@@@@@@@@@       @@ @@@@
@@@@@@@@@@ @@@@@@@@@@@@@@@@@@@@@@@ @@@@@@@@@@ @@@@@ @@ @@@@
@@         @@@@@@@@@@@@               @@@@@@@ @@ @@ @@ @@@@
@@ @@@@@@@ @@@@@@@@@@@@ @@@@@@@@@@@@@ @@@@@@@ @@    @@ @@@@
@@ @@@@@@@ @@@@@@@@@@@@ @@@@@ @@@@@@@ @@@@@@@ @@@@@@@@ @@@@
@@ @@@@@@@ @@@@@@@@@@@@ @@@@@ @@@@@@@ @@@@@@@          @@@@
@@ @@@@@@@              @@@@@ @@@@@@@ @@@@@@@@@@@@@@@@@@@@@
@@ @@@@@@@@@@@@@ @@@@@@@@@@@@ @@@@@@@               @@@@@@@
@@ @@@@@@@@@@@@@ @@@@@@@@@@@@ @@@@@@@ @@@@@@@@@@@@@ @@@@@@@
@@ @@@@@@@@@@@@@              @@@@@@@ @@@@@@@@@@@@@ @@@@@@@
@@ @@@@@@@@@@@@@@@@@@@@@@@@@@@@@@@@@@ @@@@@@@@@@@@@     @@@
@@ @@@@@@@@@@@@@@@@@@@@@@@@      @@@@ @@@@@@@@@@@@@@@@@@@@@
@@              @@@ @@@@@@@ @@@@ @@@@ @@@@@@@@@@@@@@@@@@@@@
@@ @@@@@@ @@@@@@@@@ @@@@@@@ @@@@ @@@@              @@@@@@@@
@@ @@@@@@ @@@@@@@@@ @@@@@@@ @@@@ @@@@@@@@@@@@@@@@@ @@@@@@@@
@  @@@@@@                   @@@@          @@@@@@@@
@@@@@@@@@@@@@@@@@@@@@@@@@@@@@@@@@@@@@@@@@@@@@@@@@@@@@@@@@@@